clark6       # Description:	Debian GNU/Linux 8.7 (jessie)
asimov       # Description:	Debian GNU/Linux 7.11 (wheezy)
clark-cinco  # Description:	Debian GNU/Linux 8.6 (jessie)
asimov-dos   # Description:	Debian GNU/Linux 8.10 (jessie)
arquimedes   # Description:	Debian GNU/Linux 9.5 (stretch)
copernico    # Description:	Debian GNU/Linux 9.6 (stretch)
faraday      # Description:	Debian GNU/Linux 9.6 (stretch)
euler        # Description:	Debian GNU/Linux 9.6 (stretch)
carver       # Description:	Ubuntu 18.04.1 LTS
einstein-dos # Description:	Ubuntu 18.04.1 LTS
heisenberg   # Command '['ssh', 'heisenberg', '/bin/sh']' returned non-zero exit status 127.
nolan        # Description:	Debian GNU/Linux 8.10 (jessie)
rinchen-dos  # Description:	Debian GNU/Linux 8.11 (jessie)
peano        # Description:	Debian GNU/Linux 9.6 (stretch)
rinchen      # Description:	Debian GNU/Linux 9.6 (stretch)
torvalds     # Description:	Ubuntu 18.04.1 LTS
scipionbox   # Description:	Ubuntu 16.04.3 LTS
finlay       # Description:	Ubuntu 18.04.1 LTS
hilbert      # Command '['ssh', 'hilbert', '/bin/sh']' returned non-zero exit status 127.
behring      # Command '['ssh', 'behring', '/bin/sh']' timed out after 10 seconds
